...X.......X.......X....
.X.X..XX.X.X..XX.X.X..XX
.XXXX.X..XXXX.X..XXXX.X.
...X..X.......X....X..X.
.X.X.XXXXXXX.XX..X.X.XX.
XX....X..X....X..XX.....
...X..X....X..X.........
.X.X..XX.X.X..XX.X.X..XX
.XXXX.X..XXXXXXXXXXXXXX.
...X..X....X..X....X..X.
.X.X.XXXXX.X.XX..X.X.XX.
.X.......X.......X......