........
........
X..XX...
...XX...
........
....X...