........
........
XXXX....
...X....
.X......
.X......