........
.XXX..X.
......X.
..X.....
..X..XX.
..X.....