X.......
......X.
........
.X......
........
...X....